#####################
#*.................*#
#.##.#.#######.#.##.#
#.##.#.........#.##.#
#.##.#.###%###.#.##.#
#......#  $  #......#
#.##.#.#######.#.##.#
#.##......@......##.#
#.##.#.#######.#.##.#
#...................#
#.##.#####.#####.##.#
#.##.............##.#
#.####.#######.####.#
#.*...............*.#
#####################
